_______________________________________________________________________________
|                                                                             |
|                                                                             |
|                                                                             |
|                                                                             |
|                                                                             |
|                 /             \                                             |
|                  /           \                                              |
|                   /         \                                               |
|                    /       \                                                |
|                     /     \                                                 |
|                      /   \                                                  |
|                       / \                                                   |
|                        /                     /                              |
|                                            /   /                            |
|                                           /     /                           |
|                                          /       /                          |
|                                         /         /                         |
|                                        /           /                        |
|                                       /             /                       |
|                                                                             |
|                                                                             |
|                                                                             |
|-----------------------------------------------------------------------------|
